1111111111111
1B000100000P1
10000B1111001
10000000C0001
1BC0000000001
10000000C0011
1C011E0000CB1
1111111111111